111111111111111111
10000111111C000001
10000111111C000001
10000111111C000001
10000111111C000001
10000111111C000001
10000111111C00P001
10000111111C000001
10000111111C000001
10000111111C000001
10000111111C000001
10000111111C000001
10000111111C000001
10000111111C000001
10000111111C000001
10000111111C000001
10000111111C000001
10000111111C000001
10000111111C000001
10000111111C000E01
10000111111C000001
10000111111C000001
10000111111C000001
10000111111C000001
10000111111C000001
10000111111C000001
10000111111C000001
10000111111C000001
10000111111C000001
10000111111C000001
10000111111C000001
10000111111C000001
10000111111C00C001
111111111111111111