111111111
100P01111
10C000011
100000E01
111111111